////////////////////
/                  /
/                  /
/                  /
/                  /
/                  /
/                  /
/                  /
/                  /
///                /
/Jdp              U/
////////////////////