////////////////////
/                  /
/                  /
/                  /
/                  /
/                  /
/                  /
/                  /
/                  /
///                /
/Jdp             Kk/
////////////////////