////////////////////
/                  /
/                  /
/                  /
/                  /
/                  /
/                  /
/                  /
/                  /
///                /
/Jdp             Uk/
////////////////////