////////////////////
/                  /
/                  /
/                  /
/                  /
/                  /
/                  /
/                  /
/                  /
///                /
/J p              A/
////////////////////