////////////////////
/S             iiii/
/ii                /
/  iii            //
/       ii         /
/       i          /
/      hi  ////    /
/                  /
/                  /
/             //////
/        p J       /
////////////////////