////////////////////
/        p J       /
/                  /
/                  /
/                  /
/                  /
/                  /
/                  /
/                  /
/                  /
/                  /
////////////////////