i
i
i
i
i
i
i
i                                                pJ         S
i                                               ///         /
iJp           m   m   m             m            h         pJ
/////////////////////////////////////////////////////////////
/////////////////////////////////////////////////////////////
