i
i
i
i
i
i
i
i                                                pJ         S
// /                                            ///         /
/Jpd          m   m   m             m            h         pJ
/////////////////////////////////////////////////////////////
/////////////////////////////////////////////////////////////
