i
i
i
i
i
i
i
i                                                pJ         S
////                                            ///         /
/Jpd          b   b   b             b            b         pJ
/////////////////////////////////////////////////////////////
/////////////////////////////////////////////////////////////
