/////////////////////////////////////////////////////////////
/                                                         pJi
/
/
/
/
/
/
/
/
/
/
/
/
/
/
/
/
/
/
/                                                         pJi
/
/
/
/
/
/
/
/
/
/
/
/
/
/
/
/
/
/J p                                                      pJi
/////////////////////////////////////////////////////////////
/////////////////////////////////////////////////////////////