#
#
#
#
#                             #
#                             #
############|#############################|###########
#p                                        |          #
#################################|####################
#                                |                    #
###################################################### 
