#
#
#
#
#                             #
#                             #
############|#############################|###########
#p          |                             |          #
#################################|####################
#                                |                    #
###################################################### 
