#
#
#
#
#                             #
#          =-=                #
############|#############################|###########
#p         =:=                            |          #
#################################|####################
#                                |                   #
###################################################### 
