#
#
#
#
#                             #
#          =-=                #          =-=
############|#############################|###########
#p         =:=                  =-=      =:=         #
#################################|####################
#                               =:=                  #
###################################################### 
