#
#
#
#
#                             #
#          =-=                #          =-=
############|#############################|###########
#p         =:=                  =-=      =:=         #
################# ###############|####################
#                               =:=                  #
######################################################
