&&&&&&&&&&&&&&&&&&&&&&&&&&&&&&&&&&&&&&&&&&&&&&&&&&&&&&
&     =-=&         &                                 &
&  E   | &         &                                 &
&&&&&&&|&&         &                                 &
&K    =:=     p    &                                 &
&&&&&&&&&&&&&&&&&&&&&&&&&&&&&&&&&&&&&&&&&&&&&&&&&&&&&&