####################
#                  #
#                  #
#                  #
#                  #
#                  #
#                  #
#                  #
#                  #
###                #
#Jdp             Kk#
####################