####################
#                  #
#                  #
#                  #
#                  #
#                  #
#                  #
#                  #
#                  #
###                #
#JDp             Kk#
####################