####################
#                  #
#                  #
#                  #
#                  #
#                  #
#                  #
#                  #
#                  #
###                #
#JDp             K #
####################