i
i
i
i
i
i
i
i                                                           S
i                                                           #
iJp           m   m   m             m            h         pJ
#######################################    ##################
#######################################    ##################
