&&&&&&&&&&&&&&&&&&&&&&&&&&&&&&&&&&&&&&&&&&&&&&&&&&&&&&
&     =-=&         &                                 &
&  E   | &         &                                 &
&&&&&&&|&&         &                                 &
&K    =:=   s p    &                                 &
&&&&&&&&&&&&&&&&&&&&&&&&&&&&&&&&&&&&&&&&&&&&&&&&&&&&&&