&&&&&&&&&&&&&&&&&&&&&&&&&&&&&&&&&&&&&&&&&&&&&&&&&&&&&&
&     =-=&         &                                 &
&  E   | &         &                                 &
&&&&&&&|&&         &                                 &
&K    =:=   s p  J &                                 &
&&&&&&&&&&&&&&&&&&&&&&&&&&&&&&&&&&&&&&&&&&&&&&&&&&&&&&