i
i
i
i
i
i
i                    ##
i                    ##                                    S
i                   ###                                    #
iJp # =-=           ###              m         h          pJ
#######|######### #####  ################ ##################
#######|######### #####  ################ ##################
