\\\\\\\\\\\\\\\\\\\\\\\\\\\\\\\\\\\\
\                                  \
\                                  \
\                                  \
\                                  \
\                                  \
\                                  \
\                                  \
\                                  \
\      \\\\\\\\\\\\\\\\            \
\p                               R \
\\\\\\\\\\\\\\\\\\\\\\\\\\\\\\\\\\\\