\\\\\\\\\\\\\\\\\\\\\\\\\\\\\\\\\\\\
\                                  \
\                                  \
\                                  \
\                                  \
\                                  \
\                                  \
\                                  \
\                                  \
\                                  \
\p                               R \
\\\\\\\\\\\\\\\\\\\\\\\\\\\\\\\\\\\\