\\\\\\\\\\\\\\\\\\\\\\\\\\\\\\\\\\\\
\                                  \
\                                  \
\                                  \
\                                  \
\                                  \
\                                  \
\                                  \
\                                  \
\                                  \
\p                               K \
\\\\\\\\\\\\\\\\\\\\\\\\\\\\\\\\\\\\