\\\\\\\\\ \\\\\\\\\\
\\\\\\\\\ \\\\\\\\\\
\\\\\\\\\ \\\\\\\\\\
\\\\\\\\\ \\\\\\\\\\
\\\\\\\\\ \\\\\\\\\\
\\\\\\\\\ \\\\\\\\\\
\\\\\\\\\ \\\\\\\\\\
\\\\\\\\\p\\\\\\\\\\
\\\\\\\\\ \\\\\\\\\\
\\\\\\\\\ \\\\\\\\\\
\\\\\\\\\ \\\\\\\\\\
\\\\\\\\\ \\\\\\\\\\
\\\\\\\\\ \\\\\\\\\\
\\\\\\\\\ \\\\\\\\\\
\\\\\\\\\ \\\\\\\\\\
\\\\\\\\\ \\\\\\\\\\
\\\\\\\\\ \\\\\\\\\\
\\\\\\\\\ \\\\\\\\\\
\\\\\\\\\ \\\\\\\\\\
\\\\\\\\\ \\\\\\\\\\
\\\\\\\\\ \\\\\\\\\\
\\\\\\\\\ \\\\\\\\\\
\\\\\\\\\ \\\\\\\\\\
\\\\\\\\\ \\\\\\\\\\
\\\\\\\\\ \\\\\\\\\\
\\\\\\\\\ \\\\\\\\\\
\\\\\\\\\ \\\\\\\\\\
\\\\\\\\\ \\\\\\\\\\
\\\\\\\\\ \\\\\\\\\\
\\\\\\\\\ \\\\\\\\\\
\\\\\\\\\ \\\\\\\\\\
\\\\\\\\\ \\\\\\\\\\
\\\\\\\\\ \\\\\\\\\\
\\\\\\\\\ \\\\\\\\\\
\\\\\\\\\ \\\\\\\\\\
\\\\\\\\\ \\\\\\\\\\
\\\\\\\\\ \\\\\\\\\\
\\\\\\\\\ \\\\\\\\\\
\\\\\\\\\ \\\\\\\\\\
\\\\\\\\\ \\\\\\\\\\
\\\\\\\\\ \\\\\\\\\\
\\\\\\\\\ \\\\\\\\\\
\\\\\\\\\ \\\\\\\\\\
\\\\\\\\\ \\\\\\\\\\
\\\\\\\\\ \\\\\\\\\\
\\\\\\\\\ \\\\\\\\\\
\\\\\\\\\ \\\\\\\\\\
\\\\\\\\\ \\\\\\\\\\
\\\\\\\\\ \\\\\\\\\\
\\\\\\\\\ \\\\\\\\\\
\\\\\\\\\ \\\\\\\\\\
\\\\\\\\\ \\\\\\\\\\
\\\\\\\\\ \\\\\\\\\\
\\\\\\\\\ \\\\\\\\\\
\\\\\\\\\ \\\\\\\\\\
\\\\\\\\\ \\\\\\\\\\
\\\\\\\\\ \\\\\\\\\\
\\\\\\\\\ \\\\\\\\\\
\\\\\\\\\ \\\\\\\\\\
\\\\\\\\\ \\\\\\\\\\
\\\\\\\\\ \\\\\\\\\\
\\\\\\\\\ \\\\\\\\\\
\\\\\\\\\ \\\\\\\\\\
\\\\\\\\\ \\\\\\\\\\
\\\\\\\\\ \\\\\\\\\\
\\\\\\\\\ \\\\\\\\\\
\\\\\\\\\ \\\\\\\\\\
\\\\\\\\\ \\\\\\\\\\
\\\\\\\\\ \\\\\\\\\\
\\\\\\\\\ \\\\\\\\\\
\\\\\\\\\ \\\\\\\\\\
\\\\\\\\\ \\\\\\\\\\
\\\\\\\\\ \\\\\\\\\\
\\\\\\\\\ \\\\\\\\\\
\\\\\\\\\ \\\\\\\\\\
\\\\\\\\\ \\\\\\\\\\
\\\\\\\\\ \\\\\\\\\\
\\\\\\\\\ \\\\\\\\\\
\\\\\\\\\ \\\\\\\\\\
\\\\\\\\\ \\\\\\\\\\
\\\\\\\\\ \\\\\\\\\\
\\\\\\\\\ \\\\\\\\\\
\\\\\\\\\ \\\\\\\\\\
\\\\\\\\\ \\\\\\\\\\
\\\\\\\\\ \\\\\\\\\\
\\\\\\\\\ \\\\\\\\\\
\\\\\\\\\ \\\\\\\\\\
\\\\\\\\\ \\\\\\\\\\
\\\\\\\\\ \\\\\\\\\\
\\\\\\\\\ \\\\\\\\\\
\\\\\\\\\ \\\\\\\\\\
\\\\\\\\\ \\\\\\\\\\
\\\\\\\\\ \\\\\\\\\\
\\\\\\\\\ \\\\\\\\\\
\\\\\\\\\ \\\\\\\\\\
\\\\\\\\\ \\\\\\\\\\
\\\\\\\\\ \\\\\\\\\\
\\\\\\\\\ \\\\\\\\\\
\\\\\\\\\ \\\\\\\\\\
\\\\\\\\\ \\\\\\\\\\
\\\\\\\\\ \\\\\\\\\\
\\\\\\\\\ \\\\\\\\\\
\\\\\\\\\ \\\\\\\\\\
\\\\\\\\\ \\\\\\\\\\
\\\\\\\\\ \\\\\\\\\\
\\\\\\\\\ \\\\\\\\\\
\\\\\\\\\ \\\\\\\\\\
\\\\\\\\\ \\\\\\\\\\
\\\\\\\\\ \\\\\\\\\\
\\\\\\\\\ \\\\\\\\\\
\\\\\\\\\ \\\\\\\\\\
\\\\\\\\\ \\\\\\\\\\
\\\\\\\\\ \\\\\\\\\\
\\\\\\\\\ \\\\\\\\\\
\\\\\\\\\ \\\\\\\\\\
\\\\\\\\\ \\\\\\\\\\
\\\\\\\\\ \\\\\\\\\\
\\\\\\\\\ \\\\\\\\\\
\\\\\\\\\ \\\\\\\\\\
\\\\\\\\\ \\\\\\\\\\
\\\\\\\\\ \\\\\\\\\\
\\\\\\\\\ \\\\\\\\\\
\\\\\\\\\ \\\\\\\\\\
\\\\\\\\\ \\\\\\\\\\
\\\\\\\\\ \\\\\\\\\\
\\\\\\\\\ \\\\\\\\\\
\\\\\\\\\ \\\\\\\\\\
\\\\\\\\\ \\\\\\\\\\
\\\\\\\\\ \\\\\\\\\\
\\\\\\\\\ \\\\\\\\\\
\\\\\\\\\ \\\\\\\\\\
\\\\\\\\\ \\\\\\\\\\
\\\\\\\\\ \\\\\\\\\\
\\\\\\\\\ \\\\\\\\\\
\\\\\\\\\ \\\\\\\\\\
\\\\\\\\\ \\\\\\\\\\
\\\\\\\\\ \\\\\\\\\\
\\\\\\\\\ \\\\\\\\\\
\\\\\\\\\ \\\\\\\\\\
\\\\\\\\\ \\\\\\\\\\
\\\\\\\\\ \\\\\\\\\\
\\\\\\\\\ \\\\\\\\\\
\\\\\\\\\ \\\\\\\\\\
\\\\\\\\\J\\\\\\\\\\
\\\\\\\\\ \\\\\\\\\\
\\\\\\\\\ \\\\\\\\\\
\\\\\\\\\ \\\\\\\\\\
\\\\\\\\\ \\\\\\\\\\
\\\\\\\\\ \\\\\\\\\\
\\\\\\\\\ \\\\\\\\\\